abstract-objects::Abstract Objects::abstract objects::Metaphysics::schaffer::rosen
actualism::Actualism::actualism|modalitySUBmetaphysics of::Metaphysics::mackie::cmenzel
events::Events::events::Metaphysics::nolan::casati|varzi
existence::Existence::existence|being::Metaphysics::bricker::mnelson
fictionalism-modal::Modal Fictionalism::fictionalismSUBmodal|modalitySUBmodal fictionalism::Metaphysics::bricker::nolan
future-contingents::Future Contingents::future contingents::Metaphysics::macfarlane::pohrstrom|phasle
holes::Holes::holes::Metaphysics::nolan::casati|varzi
identity-indiscernible::The Identity of Indiscernibles::identitySUBof indiscernibles::Metaphysics::schaffer::pforrest
identity-relative::Relative Identity::identitySUBrelative::Metaphysics::mackie::deutsch
mereology::Mereology::mereology|part/whole::Metaphysics::schaffer::varzi
metaphysics::Metaphysics::metaphysics::Metaphysics::rosen::pinwagen|msullivan
properties::Properties::properties|relations|universals|attributes::Metaphysics::rosen::swoyer|forilia
propositions-singular::Singular Propositions::propositionsSUBsingular::Metaphysics::mackie::gfitch|mnelson
propositions-structured::Structured Propositions::propositionsSUBstructured::Metaphysics::bricker::king
propositions::Propositions::propositions::Metaphysics::bricker::mmcgrath
relativism::Relativism::relativism::Metaphysics::rosen::swoyer|mbaghramian|acarter1
tropes::Tropes::tropes|qualiton|relaton::Metaphysics::bricker::amaurin
truth-coherence::The Coherence Theory of Truth::truthSUBcoherence theory of::Metaphysics::schaffer::joyoung
truth-deflationary::The Deflationary Theory of Truth::truthSUBdeflationary theory of::Metaphysics::varzi::stoljar|ndamnjanovic
truth-identity::The Identity Theory of Truth::truthSUBidentity theory of::Metaphysics::varzi::candlish|ndamnjanovic
essential-accidental::Essential vs. Accidental Properties::essential vs. accidental properties|accidental properties|essentialism|propertiesSUBessential vs. accidental::Metaphysics::nolan::trobertson|patkins
time::Time::time|being and becoming::Metaphysics::bricker::nmarkosian
death::Death::death::Metaphysics::nolan::sluper
properties-emergent::Emergent Properties::emergent properties|propertiesSUBemergent::Metaphysics::schaffer::toconnor|hwong
predication-instantiation::Predication::predication::Metaphysics::bricker::NA
facts::Facts::facts::Metaphysics::nolan::kmulligan|fcorreia
fatalism::Fatalism::fatalism::Metaphysics::mackie::hrice
fiction::Fiction::fiction::Metaphysics::rosen::kroon|avoltolini
fictionalism::Fictionalism::fictionalism::Metaphysics::rosen::meklund
individuals::Individuals and Individuation::individuals and individuation|particulars::Metaphysics::mackie::NA
intrinsic-extrinsic::Intrinsic vs. Extrinsic Properties::intrinsic vs. extrinsic properties|extrinsic::Metaphysics::bricker::bweatherson|dmarshall
material-constitution::Material Constitution::material constitution::Metaphysics::schaffer::rwasserman
monism::Monism::monism::Metaphysics::bricker::schaffer
naturalism::Naturalism::naturalism::Metaphysics::rosen::dpapineau
natural-kinds::Natural Kinds::natural kinds::Metaphysics::mackie::abird|etobin
object::Object::object::Metaphysics::schaffer::hlaycock
ontological-commitment::Ontological Commitment::ontological commitment::Metaphysics::nolan::bricker
paradox-zeno::Zeno\'s Paradoxes::Zeno of EleaSUBZeno\'s paradoxes|paradoxSUBZeno\'s paradoxes::Metaphysics::schaffer::nhuggett
identity-personal::Personal Identity::personal identity|persons|identitySUBpersonal::Metaphysics::mackie::eolson
platonism::Platonism in Metaphysics::PlatonismSUBin metaphysics::Metaphysics::rosen::mbalaguer
possible-worlds::Possible Worlds::possible worlds|worldsSUBpossible|modalitySUBpossible worlds::Metaphysics::bricker::cmenzel
possible-objects::Possible Objects::possible objects|counterpart theory|modalitySUBpossible objects::Metaphysics::bricker::tyagisawa
pragmatism::Pragmatism::pragmatism::Metaphysics::mackie::chookway
process-philosophy::Process Philosophy::process philosophy::Metaphysics::floyd::jseibt
states-of-affairs::States of Affairs::states of affairs::Metaphysics::mackie::mtextor
substance::Substance::substance|body|bundle theory|haecceity|inherence::Metaphysics::mackie::hrobinson
truth-correspondence::The Correspondence Theory of Truth::truthSUBcorrespondence theory of::Metaphysics::schaffer::mdavid
types-tokens::Types and Tokens::types and tokens::Metaphysics::nolan::lwetzel
value-intrinsic-extrinsic::Intrinsic vs. Extrinsic Value::valueSUBintrinsic vs. extrinsic::Metaphysics|Ethics [Metaethics]::mackie|svavarsdottir::mzimmerman
value-theory::Value Theory::value theory::Metaphysics|Ethics [Metaethics]::rosen|svavarsdottir::mschroeder
analysis::Analysis::analysis::Metaphysics|20th Century Philosophy::rosen::mbeaney
antirealism::Anti-Realism::anti-realism::Metaphysics::rosen::NA
boundary::Boundary::boundary::Metaphysics::nolan::varzi
categories::Categories::categories::Metaphysics::nolan::athomasson
causation-metaphysics::The Metaphysics of Causation::causationSUBthe metaphysics of::Metaphysics::bricker::schaffer
change::Change and Inconsistency::changeSUBand inconsistency::Metaphysics::nolan::cmortens
identity::Identity::identity::Metaphysics::mackie::hnoonan|bcurtis
determinate-determinables::Determinates vs. Determinables::determinates vs. determinables::Metaphysics::schaffer::dsanford|jwilson
dependence-ontological::Ontological Dependence::dependence, ontological|ontological dependence::Metaphysics::nolan::elowe
idealism::Idealism::idealism::Metaphysics::wood|forster::guyer|rhorstmann
logic-ontology::Logic and Ontology::logic and ontology::Metaphysics|Logic [Philosophy of]::macfarlane|schaffer::thofweber
nominalism-metaphysics::Nominalism in Metaphysics::nominalismSUBin metaphysics::Metaphysics::rosen::pereyra
nonexistent-objects::Nonexistent Objects::nonexistent objects::Metaphysics::rosen::mreicher
nothingness::Nothingness::nothingness::Metaphysics::mackie::sorensen
reism::Reism::reism::Metaphysics::nolan::jwolenski
realism::Realism::realism::Metaphysics::schaffer::amiller
temporal-parts::Temporal Parts::temporal parts|persistence|four dimensionalism::Metaphysics::mackie::khawley
psychologism::Psychologism::psychologism::Metaphysics::nolan::mkusch
identity-transworld::Transworld Identity::identitySUBtransworld|transworld identity::Metaphysics::nolan::mackie|mjago
identity-time::Identity Over Time::identitySUBover time::Metaphysics::schaffer::agallois
problem-of-many::The Problem of the Many::many, problem of|composition, the vagueness of|vagueness of composition::Metaphysics::bricker::bweatherson
time-travel::Time Travel::time travel::Metaphysics::schaffer::nsmith
sounds::Sounds::sounds::Metaphysics::varzi::casati|jdokic
simplicity::Simplicity::simplicity::Metaphysics|Logic [Philosophy of]::rosen::abaker
truthmakers::Truthmakers::truthmakers::Metaphysics::schaffer::fmacbride
sortals::Sortals::sortals::Metaphysics::rosen::rgrandy
lewis-metaphysics::David Lewis\'s Metaphysics::Lewis, DavidSUBmetaphysics::Metaphysics::bricker::nhall
dispositions::Dispositions::dispositions::Metaphysics|Philosophy of Science|Philosophy of Mind::rosen|hitchcock::schoi|mfara
transcendental-arguments::Transcendental Arguments::transcendental arguments::Metaphysics|Epistemology::conee::rstern
conceptualism::Conceptualism::conceptualism::Metaphysics::mackie::NA
metaphysics-massexpress::The Metaphysics of Mass Expressions::mass expressionsSUBmetaphysics of::Metaphysics::nolan::msteen
animalism::Animalism::animalism::Metaphysics|Philosophy of Mind::rosen::sblatti
location-mereology::Location and Mereology::location and mereology|mereologySUBand location::Metaphysics::schaffer::cgilmore
ordinary-objects::Ordinary Objects::ordinary objects::Metaphysics::schaffer::dkorman
modality-varieties::Varieties of Modality::modalitySUBvarieties of::Metaphysics::rosen::bkment
relations::Relations::relations::Metaphysics::schaffer::fmacbride
natural-properties::Natural Properties::propertiesSUBnatural::Metaphysics::nolan::cdorr
ontology::Ontology::ontology::Metaphysics::bricker::NA
grounding::Metaphysical Grounding::grounding, metaphysical::Metaphysics::rosen::rbliss|ktrogdon
haecceitism::Haecceitism::haecceitism::Metaphysics::bricker::scowling
